1111111111111
1001C000C10P1
1C01110111001
100000000E001
1111111111111