1111111111111
10000000000P1
100000C000001
100000000E001
1111111111111