1111111111111
1C001000000P1
111010CN10001
110000001E001
1C01100010001
1111111111111