1111111111111
1C001000000P1
111010C010001
10N000001E001
1C01100010001
1111111111111